10 10
1 1 1 1 1 1 1 1 1 1
1 0 0 0 0 0 0 0 0 1
1 0 1 0 0 1 0 0 0 1
1 0 1 0 1 1 1 0 0 1
1 0 0 1 0 0 0 0 r 1
1 0 0 1 1 1 0 0 1 1
1 0 0 0 0 1 1 1 1 1
1 0 0 0 0 0 0 0 1 1
1 0 0 0 p 1 0 1 e 1
1 1 1 1 1 1 1 1 1 1 